21 6
111111111111111111111
100100001000000000021
100111001000011111111
100000001000010000001
100000000000000000001
111111111111111111111
1 1