19 21
1111111111111111111
1222220301222222221
1211211121211121121
1222222222222222221
1211212111112121121
1222212221222122221
1111211121211121111
1111212220222121111
1111212113112121111
1222222100012222221
1111212111112121111
1111210302222121111
1111012111112121111
1220302221222222221
1211011121211121121
1221222220000001221
1121212111112101211
1222212221222100001
1211111121211111121
1222222222222222221
1111111111111111111
17 17